111111111111111111111
142202202202202202201
101101101101101101101
121121121121121121121
101101101101101101101
102202202202202202201
101111111010111111101
100202020515020202001
101111111010111111101
120202020515020202021
101111111111111111101
120202020212020202021
111111111151101101221
121221221222101101111
102202202202202200261
111111111111111111111