111111111111111111111
142202202202202202201
101101111111111111101
121120050020050020021
111101101101101101101
102202202202202202201
101111111012111111111
101202120212020202061
111111111111111111111