111111111111111111111111111111
140202020202020202020202020201
101111111111111111111111111121
102020202020251152020202020201
101111111111101101111111111101
102020202020202020202020202021
121211111110110011011111111111
111010222220110011022222002201
121210211120102201021112051121
121010211120152251021112001101
121210222220111111022222000121
121010000000000000000000000101
121212111212121105112121112121
121212111212121100112121112101
121212020202020202020202020121
121010111111111111111111111101
121212020202020202020202020121
101010111111111111111111112101
120202020202020202020202020161
111111111111111111111111111111